"aa" = (/turf/simulated/floor/plating/asteroid/airless,/area/space)
"ab" = (/turf/simulated/wall/rust,/area/space)
"ac" = (/obj/item/weapon/book/manual/chef_recipes,/turf/simulated/floor/plating/airless{icon_plating = "asterioidplating"; icon_state = "asteroidplating"},/area/space)
"ad" = (/obj/structure/girder,/turf/simulated/floor/plating/airless{icon_plating = "asterioidplating"; icon_state = "asteroidplating"},/area/space)
"ae" = (/turf/simulated/floor/plating/airless{icon_plating = "asterioidplating"; icon_state = "asteroidplating"},/area/space)
"af" = (/obj/item/body_egg/alien_embryo,/turf/simulated/floor/plating/airless{icon_plating = "asterioidplating"; icon_state = "asteroidplating"},/area/space)
"ag" = (/obj/effect/decal/cleanable/blood/gibs/old,/obj/effect/spider/stickyweb,/turf/simulated/floor/plating/airless,/area/space)
"ah" = (/obj/structure/table_frame,/obj/effect/spawner/lootdrop/maintenance,/turf/simulated/floor/plating/airless,/area/space)
"ai" = (/obj/structure/table,/obj/item/weapon/kitchen/knife,/obj/effect/spider/stickyweb,/obj/item/clothing/gloves/color/latex,/turf/simulated/floor/plating/airless,/area/space)
"aj" = (/obj/structure/table,/obj/machinery/microwave,/obj/effect/decal/cleanable/cobweb{tag = "icon-cobweb2"; icon_state = "cobweb2"},/obj/effect/spider/stickyweb,/turf/simulated/floor/plating/airless,/area/space)
"ak" = (/obj/structure/girder/displaced,/turf/simulated/floor/plating/airless{icon_plating = "asterioidplating"; icon_state = "asteroidplating"},/area/space)
"al" = (/obj/structure/closet/secure_closet/freezer/meat,/obj/item/weapon/reagent_containers/food/snacks/burger/xeno{bonus_reagents = list("nutriment" = 2, "vitamin" = 6, "space_drugs" = 4, "carpotoxin" = 1); desc = "A moldy burger, looks likes its been left out for awhile. Eugh."; name = "moldy burger"},/turf/simulated/floor/plating/airless{icon_plating = "asterioidplating"; icon_state = "asteroidplating"},/area/space)
"am" = (/obj/effect/decal/cleanable/blood/gibs/old,/turf/simulated/floor/plating/airless,/area/space)
"an" = (/obj/item/stack/sheet/metal,/turf/simulated/floor/plating/airless,/area/space)
"ao" = (/obj/effect/decal/cleanable/ash,/obj/effect/decal/cleanable/blood/drip,/obj/item/clothing/suit/apron/chef,/turf/simulated/floor/plating/airless,/area/space)
"ap" = (/obj/effect/decal/remains/human,/turf/simulated/floor/plating/airless,/area/space)
"aq" = (/obj/effect/decal/cleanable/vomit/old,/obj/effect/spider/stickyweb,/turf/simulated/floor/plasteel/airless,/area/space)
"ar" = (/obj/effect/decal/cleanable/blood/drip,/obj/effect/spider/stickyweb,/turf/simulated/floor/plasteel/airless,/area/space)
"as" = (/obj/effect/decal/cleanable/cobweb,/turf/simulated/floor/plasteel/airless,/area/space)
"at" = (/obj/machinery/light/built{tag = "icon-tube1 (NORTH)"; icon_state = "tube1"; dir = 1},/turf/simulated/floor/plasteel/airless,/area/space)
"au" = (/obj/effect/decal/cleanable/vomit/old,/turf/simulated/floor/plasteel/airless,/area/space)
"av" = (/obj/structure/noticeboard{pixel_y = 32},/obj/item/weapon/paper/crumpled{info = "Due to unsanitary conditions and other violations of general health guidelines, this restraunt has been marked with a notice of closure and will be shutdown until more sanitary conditions are met and shown to be kept.<br><br><i>Health Inspector #3345</i>"},/turf/simulated/floor/plasteel/airless,/area/space)
"aw" = (/obj/effect/decal/cleanable/blood/drip,/turf/simulated/floor/plasteel/airless,/area/space)
"ax" = (/obj/effect/decal/cleanable/ash,/turf/simulated/floor/plasteel/airless,/area/space)
"ay" = (/turf/simulated/floor/plasteel/airless,/area/space)
"az" = (/obj/structure/table_frame,/turf/simulated/floor/plating/airless,/area/space)
"aA" = (/obj/structure/table/reinforced,/turf/simulated/floor/plating/airless,/area/space)
"aB" = (/obj/item/stack/rods,/turf/simulated/floor/plating/airless,/area/space)
"aC" = (/obj/structure/table/reinforced,/obj/item/weapon/broken_bottle,/turf/simulated/floor/plasteel/airless,/area/space)
"aD" = (/obj/structure/table/reinforced,/obj/effect/decal/cleanable/blood/drip,/obj/item/weapon/reagent_containers/food/drinks/drinkingglass,/turf/simulated/floor/plasteel/airless,/area/space)
"aE" = (/obj/structure/grille,/obj/structure/window{tag = "icon-window (EAST)"; icon_state = "window"; dir = 4},/obj/structure/window{tag = "icon-window (NORTH)"; icon_state = "window"; dir = 1},/turf/simulated/floor/plating/airless{icon_plating = "asterioidplating"; icon_state = "asteroidplating"},/area/space)
"aF" = (/obj/item/weapon/shard,/turf/simulated/floor/plating/airless{icon_plating = "asterioidplating"; icon_state = "asteroidplating"},/area/space)
"aG" = (/turf/simulated/floor/plating/airless,/area/space)
"aH" = (/obj/item/weapon/shard,/obj/effect/decal/cleanable/blood/gibs/old,/turf/simulated/floor/plating/airless{icon_plating = "asterioidplating"; icon_state = "asteroidplating"},/area/space)
"aI" = (/obj/structure/grille{color = "#008000"; density = 0; icon_state = "brokengrille"},/turf/simulated/floor/plating/airless{icon_plating = "asterioidplating"; icon_state = "asteroidplating"},/area/space)
"aJ" = (/obj/item/weapon/shard,/turf/simulated/floor/plating/asteroid/airless,/area/space)
"aK" = (/obj/structure/grille,/turf/simulated/floor/plating/airless{icon_plating = "asterioidplating"; icon_state = "asteroidplating"},/area/space)
"aL" = (/obj/structure/stool/bed/chair{dir = 4},/turf/simulated/floor/plating/airless{icon_plating = "asterioidplating"; icon_state = "asteroidplating"},/area/space)
"aM" = (/obj/structure/table/wood,/obj/item/weapon/reagent_containers/food/drinks/drinkingglass,/turf/simulated/floor/plating/airless,/area/space)
"aN" = (/obj/structure/stool/bed/chair{dir = 8},/turf/simulated/floor/plating/airless,/area/space)
"aO" = (/obj/effect/decal/cleanable/blood/drip,/turf/simulated/floor/plating/airless,/area/space)
"aP" = (/obj/structure/stool/bed/chair{dir = 4},/obj/effect/decal/cleanable/ash,/turf/simulated/floor/plating/airless,/area/space)
"aQ" = (/obj/structure/table_frame/wood,/obj/item/weapon/kitchen/fork,/turf/simulated/floor/plating/airless,/area/space)
"aR" = (/obj/structure/stool/bed/chair{dir = 8},/obj/effect/decal/cleanable/blood/gibs/old,/turf/simulated/floor/plating/airless{icon_plating = "asterioidplating"; icon_state = "asteroidplating"},/area/space)
"aS" = (/obj/structure/grille,/obj/structure/barricade/wooden,/turf/simulated/floor/plating/airless{icon_plating = "asterioidplating"; icon_state = "asteroidplating"},/area/space)
"aT" = (/obj/item/stack/sheet/metal,/turf/simulated/floor/plating/airless{icon_plating = "asterioidplating"; icon_state = "asteroidplating"},/area/space)
"aU" = (/obj/effect/decal/cleanable/ash,/turf/simulated/floor/plating/airless,/area/space)
"aV" = (/obj/effect/decal/cleanable/blood/gibs/old,/turf/simulated/floor/plating/airless{icon_plating = "asterioidplating"; icon_state = "asteroidplating"},/area/space)
"aW" = (/obj/item/stack/sheet/metal,/turf/simulated/floor/plating/asteroid/airless,/area/space)
"aX" = (/obj/structure/table_frame/wood,/obj/item/stack/sheet/mineral/wood,/turf/simulated/floor/plating/airless{icon_plating = "asterioidplating"; icon_state = "asteroidplating"},/area/space)
"aY" = (/obj/structure/stool/bed/chair{dir = 8},/turf/simulated/floor/plating/airless{icon_plating = "asterioidplating"; icon_state = "asteroidplating"},/area/space)
"aZ" = (/obj/structure/sign/kiddieplaque{desc = "Among the rust-covered plaque, you can make out '<i>Family-Owned for over 20 years, we here at --_-_- take great pride in our food service and family-friendly enviroment!</i>'"; name = "rusted plaque"; pixel_y = -32},/turf/simulated/floor/plating/airless{icon_plating = "asterioidplating"; icon_state = "asteroidplating"},/area/space)
"ba" = (/obj/effect/decal/cleanable/blood/drip,/turf/simulated/floor/plating/airless{icon_plating = "asterioidplating"; icon_state = "asteroidplating"},/area/space)
"bb" = (/obj/effect/decal/remains/human,/turf/simulated/floor/plating/airless{icon_plating = "asterioidplating"; icon_state = "asteroidplating"},/area/space)
"bc" = (/obj/structure/grille{color = "#008000"; density = 0; icon_state = "brokengrille"},/obj/structure/barricade/wooden,/turf/simulated/floor/plating/airless{icon_plating = "asterioidplating"; icon_state = "asteroidplating"},/area/space)
"bd" = (/obj/structure/barricade/wooden,/turf/simulated/floor/plating/airless{icon_plating = "asterioidplating"; icon_state = "asteroidplating"},/area/space)
"be" = (/obj/effect/decal/cleanable/blood/drip,/obj/effect/spawner/lootdrop/maintenance{lootcount = 4; name = "4maintenance loot spawner"},/turf/simulated/floor/plating/airless{icon_plating = "asterioidplating"; icon_state = "asteroidplating"},/area/space)
"bf" = (/obj/item/weapon/shard,/obj/item/weapon/shard,/turf/simulated/floor/plating/asteroid/airless,/area/space)
"bg" = (/obj/structure/barricade/wooden,/obj/effect/decal/cleanable/blood/drip,/turf/simulated/floor/plating/airless{icon_plating = "asterioidplating"; icon_state = "asteroidplating"},/area/space)

(1,1,1) = {"
aaaaabacababadabababaaaaaaaaaa
aaaaabaeafagahaiajabaaaaaaaaaa
aaaaakalamanaoapaqabaaaaaaaaaa
aaababababababarabababaaaaaaaa
aaabasatauavawaxatayabaaaaaaaa
aaadazaAaBaCaDazaAaAaeaaaaaaaa
aaaEaFaGaBaGaGaGaGaHaIaJaaaaaa
aJaKaFaLaMaNaOaPaQaRaSaaaJaaaa
aJakaTaeaeaeaUaOaVaFadaWaaaaaa
aaabaeaLaXaYaVaZbabbabaaaaaaaa
aaababaSbcbcababbdbeadaaaaaaaa
aaaaaaaJaJbfaaabbdbgabaaaaaaaa
aaaaaaaaaaaaaaaaaaaeaaaaaaaaaa
aaaaaaaaaaaaaaaaaeaeaaaaaaaaaa
aaaaaaaaaaaaaaaaaaaeaaaaaaaaaa
"}
